The chickens were killed by a fox. 	The fox killed the chicken.| 1 1 1
My piggy bank was broken by my naughty sister. 	My naughty sister broke my piggy bank.| 1 1 1
Tom was attacked by a wolf. 	The wolf attacked Tom.| 1 1 1
The will was declared void by the court. 	The court was delighted by the court.| 0 1 0
Baena Soares was arrested by the armed forces. 	The armed forces arrested Baena Soares. | 1 1 1
Tom was eaten by a crocodile. 	The crocodile ate Tom.| 1 1 1
Tom was eaten by a tiger. 	The tiger ate Tom.| 1 1 1
Tom was killed by a giant hornet. 	The giant was killed Tom.| 0 0 0
Two sheep were killed by a wolf. 	The wolf killed two sheep.| 1 1 1
She is being blackmailed by him. 	He is blackmailing her.| 1 1 1
She was seduced by Tom. 	Tom was seduced her.| 0 0 0
He was seduced by Mary. 	Mary was seduced him.| 0 0 0
The postman was bitten by that dog. 	The dog bit the postman.| 1 1 1
Tom was trampled by a wild hippopotamus. 	Has Tom been honored a wild tape?| 0 0 0
She was arrested by the police. 	The police arrested her.| 1 1 1
9 people were assassinated by Raman Raghav. 	Raman Raghav assassinated nine people.| 1 1 1
Ibrahim Sofu was murdered by Metin Kaplan. 	Metin Kaplan murdered Ibrahim Sofu.| 1 1 1
We were attacked by pirates! 	The pirates attacked me.| 1 1 1
The street was blocked by a huge truck. 	The huge truck blocked the street.| 1 1 1
The door had been axed by the firefighters. 	The firefighters had been bitten the door.| 0 0 0
Bill was killed by that man. 	The man killed Bill.| 1 1 1
The hare was outdistanced by the tortoise. 	The tortoise gave the hare.| 0 1 1
I was bit by a mosquito. 	The mosquitoes bit me. | 1 1 1
Her toy was broken by her little sister. 	Her little sister broke her toy.| 1 1 1
Steven Jenkins was shot by a friend. 	The friend shot Steven Jenkins.| 1 1 1
A potato is being sliced by a woman 	A woman is slicing a potato| 1 1 1
She was blackmailed by him. 	He blackmailed her.| 1 1 1
A dog was run over by a truck. 	The truck was run over by the dog. | 0 1 0
I've been stung by a hornet. 	The witch stung me.| 0 1 1
Potatoes are being sliced by a woman 	A woman is slicing a potato| 1 1 1
He was devoured by a tiger. 	The tiger devoured him. | 1 1 1
Marlowe was arrested by Italian authorities. 	Italian authorities arrested Marlowe.| 1 1 1
She got kicked by a horse. 	The horse kicked her.| 1 1 1
President Alfredo Cristiani was attacked by demonstrators. 	The demonstrators attacked President Alfredo Cristiani.| 1 1 1
A banana is being eaten by a man 	A man is eating a banana| 1 1 1
Bill was killed by a burglar. 	The burglar killed Bill.| 1 1 1
He was attacked by a shark. 	The shark was attacked him.| 1 0 0
Our dog was run over by a truck. 	The truck was run over by my dog. | 0 1 0
The elephant was killed by the hunter. 	The hunter killed the elephant.| 1 1 1
The poor cat was run over by a truck. 	The truck was run over by a poor cat. | 0 1 0
Bill was killed by an intruder. 	The intruder killed Bill.| 1 1 1
The dog was hit by a car. 	The car hit the dog.| 1 1 1
The lamb was killed by the wolf. 	The wolf killed a lamb.| 1 1 1
He was accompanied by his wife. 	His wife was accompanied by his wife.| 0 1 0
I was abducted by extraterrestrials. 	We were abducted with me.| 0 0 0
The hare was overtaken by the tortoise. 	The tortoise was overtaken for the hare. | 1 0 0
My credit card was rejected by the ATM. 	The ATM was rejected my credit card. | 1 0 0
I was invited by an old friend. 	The old friend invited me.| 1 1 1
MG Rover has been bought by Airbus. 	Airbus bought Rover Rover.| 0 1 1
Actinium was discovered by André-Louis Debierne in 1899. 	André-Louis was discovered by André-Louis Debierne in 1899.| 0 1 0
The law was also criticized be the trade unions. 	The official has criticized the law. | 0 1 1
The bank was run by private citizens. 	The citizens run the bank. | 0 1 1
Kyoto is visited by many tourists. 	Most tourists are visiting Kyoto. | 1 1 1
Dan was approached by Linda. 	Linda approached Dan.| 1 1 1
The journalist was kidnapped by terrorists. 	The terrorists kidnapped the journalist.| 1 1 1
Tom's bike was stolen by a drug addict. 	The drug addict stole Tom's bike.| 1 1 1
Mary got abducted by aliens. 	The aliens was abducted by aliens.| 0 0 0
Charlemagne was crowned by the Pope. 	The Pope sank Charlemagne. | 0 1 1
The movie 'Speed'was directed by Jan De Bont. 	Jan De Bont was directed by Jan De Bont.| 0 1 0
The movie 'Speed' was directed by Jan De Bont. 	Jan De Bont was directed by Jan De Bont.| 0 1 0
Kyoto is visited by a lot of tourists. 	A lot of tourists are visiting Kyoto. | 1 1 1
In 1922, the site was acquired by Produits Chimiques Bozel Lamotte. 	Produits Lamotte acquired the site in 1922. | 0 1 1
This tree was planted by my grandfather. 	My grandfather planted a tree. | 1 1 1
The diamond was discovered by a boy in 1873. 	In 1873, the boy discovered the diamond.| 1 1 1
The coffee shop is haunted by aspiring artists. 	Some artists are haunted the coffee shop.| 0 0 0
Live At Leeds was recorded by The Who. 	The Who has recorded Live At Leeds. | 1 1 1
Mary was kidnapped by pirates. 	The pirates kidnapped Mary.| 1 1 1
"The Lord of the Rings" was directed by Peter Jackson. 	Peter Jackson was directed by Peter Jackson.| 0 1 0
Altogether 15 people were rescued by police. 	The police rescued 15 people.| 1 1 1
Some passengers were escorted off the ship in wheelchairs by crew wearing blue gloves. 	The ship was escorting the blue gloves, wearing blue gloves, wearing blue gloves.| 0 0 0
The University of Milan was founded by Gian Antonio Maggi and Giulio Vivanti. 	Gian Antonio Maggi and Giulio Vivanti founded the University of Milan.| 1 1 1
Le Beau Serge was directed by Chabrol. 	Chabrol directed Le Beau Serge. | 1 1 1
He was sent by his company to Kazakhstan. 	His company sent him to Kazakhstan.| 1 1 1
The young girl was chased by the old man. 	The old man chased a young girl.| 1 1 1
A young girl is chased by an old man. 	The old man is chased a young girl| 1 0 0
Tom was kidnapped by terrorists. 	The terrorists kidnapped Tom.| 1 1 1
I was abducted by aliens. 	I was abducted by aliens.| 1 1 0
The movie 'Speed' was directed by Jan De Bont. 	Jan De Bont was directed by Jan De Bont.| 0 1 0
The player was acclaimed by the fans. 	The fan was about the player.| 0 1 0
A piano is being played by someone 	A person is playing the piano| 1 1 1
A flute is being played by a girl 	A girl is playing a flute| 1 1 1
Tom was abducted by aliens. 	Tom was abducted by aliens.| 1 1 0
Cisco was acquired by Infogear Technology Corp. 	Infogear Technology Corp acquired Cisco.| 1 1 1
She was accepted by Harvard. 	Harvard was accepted her.| 1 0 0
The college was founded by Mr Smith. 	Mr. Smith founded the college.| 1 1 1
I was stung by a bee. 	The bee stung me.| 1 1 1
I got stung by this bee. 	The bee stung me.| 1 1 1
Tom was stung by a bee. 	Tom was stung by a bee.| 1 1 0
I got stung by a bee. 	The bee stung me.| 1 1 1
She was kissed by him. 	He kissed her.| 1 1 1
This novel was written by Emile Zola. 	Emile Zola wrote a novel.| 1 1 1
The telephone was invented by Bell in 1876. 	Bell invented the telephone in 1876.| 1 1 1
The Mona Lisa was painted by Leonardo da Vinci. 	Leonardo da Vinci painted the Mona Lisa.| 1 1 1
A hole is being burrowed by the badger 	The badger is burrowing a hole| 1 1 1
Some poems were also written by him. 	He wrote poems.| 1 1 1
The picture was painted by Picasso. 	Picasso painted the picture.| 1 1 1
That was written by Taro Akagawa. 	Taro Akagawa wrote it.| 1 1 1
This music was composed by Bach. 	Bach was composed music.| 1 0 0
The famous song "Ave Maria" was composed by Schubert. 	Schubert was composed "Ave Maria".| 0 0 0
"The Persians" were written by Aeschylus. 	Aeschylus wrote "The Persians".| 1 1 1
The picture on the wall was painted by Picasso. 	Picasso painted a picture on the wall.| 1 1 1
"Consuming Kids" was written by Susan Linn. 	Susan Linn wrote the book Consuming Kids.| 1 1 1
The poem was composed by an anonymous author. 	The anonymous author composed the poem.| 1 1 1
He was deserted by his friends. 	His friends were deserted off.| 0 1 0
Tom was fingerprinted by the police. 	The police were fingerprinted by Tom.| 0 1 0
The room wasn't tidied by Rosa. 	Rosa hasn't been woken from the room.| 0 1 0
Tom folded the blankets.	The blanket was folded by Tom.| 1 1 1
The boy ate the apple.	The apple was eating by the boy.| 1 0 0
The man ate the bread.	The bread was eating by the man.| 1 0 0
The rabbit is eating the carrot.	Carrots are being eaten by a rabbit | 1 1 1
She smoked a cigarette.	She smoked a cigarette.| 1 1 0
She drank milk.	The milk was drinking by herself.| 0 1 0
Tom was eating a sandwich.	Tom was eating by a sandwich.| 0 0 0
Tom sharpened the knife.	The knife was sharpening by Tom.| 1 0 0
Tom bit Mary.	Tom was bitten by Mary. | 0 1 1
He knocked at the door.	He knocked on the door.| 1 1 0
The Japanese attacked Pearl Harbor on December 7, 1941.	Pearl Harbor was attacked by Japanese Harbor on 7 December 1941.| 0 1 1
The dog is chewing a bone.	A bone is being chewed by a dog| 1 1 1
I pulled a triceps.	At least, I've been loaded by the triceps.| 0 1 1
The hunter shot a fox.	The fox was shot by a hunter. | 1 1 1
The hunter shoots stags and hares.	The hunter shot by the hunter.| 0 0 0
The workers are expanding the road.	The road is being boiled by the workers | 0 1 0
He sharpened the knives.	The knife was sharpening by him.| 1 0 0
The police officers have stopped me many times.	I've been stopped by a police officer often.| 1 1 1
The spies poisoned the count.	The count.n.03 was poisoned by a spy. | 1 0 1
A woman is slicing an eggplant	An eggplant is being sliced by a woman | 1 1 1
Tom unlocked the closet.	The closet unlocked Tom.| 0 1 0
She shook my hand.	My hand shook herself. | 0 1 0
Tom knocked on Mary's door.	Tom's door knocked on Mary.| 0 1 0
A crocodile has eaten Tom.	Tom ate himself a crocodile.| 0 1 0
A crocodile ate a dog.	The dog was being eaten by a crocodile.| 1 1 1
He was sharpening a knife.	The knife was sharpening by him. | 1 0 0
Tom shot Mary.	Mary shot herself. | 0 1 0
My father fixed a broken chair.	My father has fixed the broken chair. | 1 1 0
Louis Riel assassinated Scott.	Scott Riel assassinated himself. | 0 1 0
My mother boiled ten eggs.	The ten eggs was boiled by my mother.| 1 0 1
I eat a banana.	I'm eating a banana. | 1 1 0
The merchant bribed the politician.	The politician was bribe by the merchant.| 1 0 0
The archer killed the deer.	The deer was killed by the chauffeur.| 0 1 1
My dog bit Tom.	Tom was bitten by my dog.| 1 1 1
He shook his head.	His head shook him.| 0 1 0
A cat scratched me.	I was scratched by the cat. | 1 1 1
The cat scratched my hand.	My hand scratched the cat. | 0 1 0
She stabbed him with a knife.	He stabbed himself with a knife.| 0 1 0
He ate the apple.	He ate the apple.| 1 1 0
She roasted the turkey.	The turkey was aching by herself.| 0 1 0
She chopped some onions.	An onion was being chopped by her | 1 1 1
He shot her.	She shot herself. | 0 1 0
A cow is eating hay	The hay is being eaten by a cow | 1 1 1
The dog sniffed the ground.	The ground sniffed by the dog.| 1 0 0
In 1497, John Cabot explored Canada.	Canada Cabot explored Canada in 1497. | 0 1 0
The soldiers resisted the enemy attack.	The enemy attack resisted the enemy.| 0 1 0
The old man captured a big fish.	The big fish captured the man. | 0 1 0
Romania sent 730 troops in Iraq.	730 troops were sent by Romania to Iraq. | 1 1 1
The president appointed a new manager.	The president was appointed by president. | 0 1 1
Mrs. Jones teaches computer science.	Mrs. Jones teaches the Jones. | 0 1 0
My aunt inherited the huge estate.	My aunt inherited the huge estate. | 1 1 0
The brave captain saved his ship.	His ship saved him a brave captain. | 0 1 0
Tom accompanied Mary on the guitar.	Tom accompanied Mary on the guitar. | 1 1 0
The driver overtook the car.	The car was overtaken by the driver. | 1 1 1
Russia rejected both demands.	Russia rejected both demands. | 1 1 0
My friend invited me to dinner at the restaurant.	My friend in the restaurant invited me to me.| 0 1 0
Tom bought some croutons.	Tom bought himself a tree. | 0 1 0
He bought a dozen eggs.	He bought a dozen eggs. | 1 1 0
BSN bought RJR Nabisco.	RJR Nabisco bought the Nabisco Nabisco. | 0 1 0
The tourists visit the museum.	The museum is visiting by tourists. | 1 0 0
He visited Mauritania ten years ago.	Mauritania was visited by 10 years ago. | 0 1 1
She is visiting Paris.	She is visiting by herself.| 0 1 0
Extremists kidnapped the president's wife.	The wife's wife was kidnapped by heart. | 0 1 1
Looters stole ancient artifacts from the tomb.	"The ancient" ancient "was stolen by a tomb.| 0 1 1
Someone stole my bag.	My bag was stolen by someone. | 1 1 1
Someone stole Tom's car.	Tom's car was stolen by someone. | 1 1 1
Tom stole three hundred dollars from Mary.	Tom stole three hundred dollars from Mary.| 1 1 0
He acquired Russian quickly.	Russian acquired quickly.| 0 1 0
Spartan Air Lines acquired United Airways.	United Airways Lines acquired by Spartan Air Lines. | 0 1 0
PM acquired three Russian factories.	PM acquired three Russian factory. | 1 1 0
She planted some pansies in the flower bed.	She was planted by the window in the flower bed. | 0 1 0
They planted apple trees.	The apple tree was planted by someone. | 1 1 1
Tom planted three apple trees in his yard.	Three apple trees were planted by Tom in his yard. | 1 1 1
The peasants were planting rice.	The rice were planted by the peasants.| 1 1 1
We discovered a secret passageway.	I've been eager by a secret beach.| 0 1 0
The tape recorder has recorded his voice.	His voice was recorded by tape recorder.| 1 1 1
Tom rescued the cat from the flames.	The cat rescued Tom from the flames.| 0 1 0
Tom and Mary rescued an orphaned kitten.	Tom and Mary rescued an orphaned kitten.| 1 1 0
Tom and Mary played ping pong.	Tom and Mary were playing ping pong.| 1 1 0
Tom beat Mary at checkers.	Tom beat Mary by checkers.| 1 1 0
A child is playing harp.	A harp is being played by a child | 1 1 1
A dog chased a cat.	The cat chased the dog.| 0 1 0
Abrams chased Browne.	Browne chased himself. | 0 1 0
The policeman chased the burglar.	The burglar chased the policeman. | 0 1 0
Henry Ford founded the Ford Motor Company.	Henry Company was founded by Henry Ford.| 0 1 1
Tom kissed Mary.	Tom kissed Mary. | 1 1 0
A lemur is licking a person's finger	A lemur is being licked by a lemur | 0 1 1
A dog is licking a baby	A baby is licking a dog| 0 1 0
I promoted Tom.	Tom was promoted by me.| 1 1 1
The police accused him of murder.	He accused him of murder.| 0 1 0
I write poems.	This poem is written by me.| 1 1 1
Lin Piao wrote the "Little Red Book".	Lin Piao wrote by Lin Piao. | 0 0 0
She wrote 5 novels in 5 years.	She wrote five novels in five years.| 1 1 0
Alfred Nobel invented dynamite in 1866.	Alfred Nobel invented dynamite in 1866.| 1 1 0
Thomas Edison invented the electric lightbulb.	The Edison was invented by Thomas Edison.| 0 1 1
Picasso painted this picture in 1950.	The picture was painted by Picasso in 1950.| 1 1 1
He painted a dog.	The dog painted him.| 0 1 0
He composed three poems in a month.	Three poems were composed by him for a month.| 1 1 1
Tom composed a sonnet.	Tom was composed by a sonnets.| 0 0 1
The badger is burrowing a hole	A hole is being ridden by the badger | 0 1 1
He dug a hole.	He dug a hole.| 1 1 0
Tom dug a hole in the backyard.	Tom dug a hole in the backyard. | 1 1 0
The fairy changed the prince into a cat.	The prince was changed by the fairy.| 1 1 1
Tom wiped the table.	Tom wiped the table. | 1 1 0
She rinsed the dishes.	She rinsed the dishes.| 1 1 0
He robbed an old lady. 	The old lady was robbed by him. | 1 1 1
