The chickens were killed by a fox. 	The fox killed the chicken. ||1 1 1
My piggy bank was broken by my naughty sister. 	My naughty sister broke my piggy bank. ||1 1 1
Tom was attacked by a wolf. 	The wolf attacked Tom. ||1 1 1
The will was declared void by the court. 	The court murmured the court. ||0 1 0
Baena Soares was arrested by the armed forces. 	The armed forces arrested Baena Soares.||1 1 1
Tom was eaten by a crocodile. 	The crocodile ate Tom. ||1 1 1
Tom was eaten by a tiger. 	The tiger ate Tom. ||1 1 1
Tom was killed by a giant hornet. 	The bank killed Tom. ||0 1 1
Two sheep were killed by a wolf. 	The wolf killed two sheep. ||1 1 1
She is being blackmailed by him. 	He is blackmailing her. ||1 1 1
She was seduced by Tom. 	Tom seduced her. ||1 1 1
He was seduced by Mary. 	Mary seduced him. ||1 1 1
The postman was bitten by that dog. 	The dog bit the postman. ||1 1 1
Tom was trampled by a wild hippopotamus. 	The wild Ministry was trampled Tom.||0 1 1
She was arrested by the police. 	The police arrested her. ||1 1 1
9 people were assassinated by Raman Raghav. 	Raman Raghav assassinated nine people. ||1 1 1
Ibrahim Sofu was murdered by Metin Kaplan. 	Ibrahim Sofu murdered Ibrahim Kaplan. ||0 1 1
We were attacked by pirates! 	pirates attacked me. ||1 1 1
The street was blocked by a huge truck. 	The huge truck blocked the street. ||1 1 1
The door had been axed by the firefighters. 	The firefighters had been expecting the door. ||0 1 1
Bill was killed by that man. 	The man killed Bill. ||1 1 1
The hare was outdistanced by the tortoise. 	The tortoise was aiming a hare. ||0 1 1
I was bit by a mosquito. 	The mosquitoes bit me. ||1 1 1
Her toy was broken by her little sister. 	Her little sister broke her toys. ||1 1 1
Steven Jenkins was shot by a friend. 	The friends shot Steven Jenkins. ||1 1 1
A potato is being sliced by a woman 	A woman is slicing a potato ||1 1 1
She was blackmailed by him. 	He blackmailed her. ||1 1 1
A dog was run over by a truck. 	The truck was run over the dog. ||1 1 0
I've been stung by a hornet. 	The badger stung me. ||0 1 1
Potatoes are being sliced by a woman 	A woman is slicing a potato ||1 1 1
He was devoured by a tiger. 	The tiger devoured him. ||1 1 1
Marlowe was arrested by Italian authorities. 	Italian authorities arrested Marlowe. ||1 1 1
She got kicked by a horse. 	The horse kicked her. ||1 1 1
President Alfredo Cristiani was attacked by demonstrators. 	President Alfredo Cristiani attacked the demonstrators. ||0 1 1
A banana is being eaten by a man 	A man is eating a banana ||1 1 1
Bill was killed by a burglar. 	The burglar killed Bill.||1 1 1
He was attacked by a shark. 	The sharks attacked him. ||1 1 1
Our dog was run over by a truck. 	The truck was run over my dog. ||1 1 0
The elephant was killed by the hunter. 	The hunter killed the elephant. ||1 1 1
The poor cat was run over by a truck. 	The truck run over the poor cat. ||1 1 1
Bill was killed by an intruder. 	Bill killed Bill. ||0 1 1
The dog was hit by a car. 	The car hit the dog. ||1 1 1
The lamb was killed by the wolf. 	The wolf killed a lamb. ||1 1 1
He was accompanied by his wife. 	His wife accompanied him. ||1 1 1
I was abducted by extraterrestrials. 	Congratulations was abducted me. ||0 0 0
The hare was overtaken by the tortoise. 	The tortoise was preparing a hare. ||0 1 1
My credit card was rejected by the ATM. 	The ATM did my credit card. ||0 1 0
I was invited by an old friend. 	The old friend invited me. ||1 1 1
MG Rover has been bought by Airbus. 	MG Rover bought Airbus. ||0 1 1
Actinium was discovered by André-Louis Debierne in 1899. 	André-Louis Debierne was discovered at Actinium in 1899. ||0 1 0
The law was also criticized be the trade unions. 	The power was criticized the law. ||0 0 0
The bank was run by private citizens. 	The citizens ran a bank. ||0 1 1
Kyoto is visited by many tourists. 	Most tourists visit Kyoto. ||1 1 1
Dan was approached by Linda. 	Linda approached Dan. ||1 1 1
The journalist was kidnapped by terrorists. 	The journalist kidnapped the journalist. ||1 1 1
Tom's bike was stolen by a drug addict. 	The drug addict stole Tom's bike. ||1 1 1
Mary got abducted by aliens. 	The aliens was abducted Mary. ||1 0 0
Charlemagne was crowned by the Pope. 	The Pope washed Charlemagne. ||0 1 1
The movie 'Speed'was directed by Jan De Bont. 	Speed directed the movie "Speed". ||0 1 1
The movie 'Speed' was directed by Jan De Bont. 	Speed directed the movie "Speed". ||0 1 1
Kyoto is visited by a lot of tourists. 	A lot of tourists visit Kyoto. ||1 1 1
In 1922, the site was acquired by Produits Chimiques Bozel Lamotte. 	In 1922, Produits Chimiques Lamotte acquired the site. ||0 1 1
This tree was planted by my grandfather. 	My grandfather planted a tree. ||1 1 1
The diamond was discovered by a boy in 1873. 	The boy discovered the diamond in 1873. ||1 1 1
The coffee shop is haunted by aspiring artists. 	The radioactive artist is haunted a coffee shop. ||0 0 0
Live At Leeds was recorded by The Who. 	Live At Leeds has recorded The Who. ||0 1 0
Mary was kidnapped by pirates. 	pirates kidnapped Mary. ||1 1 1
"The Lord of the Rings" was directed by Peter Jackson. 	Peter Jackson directed the movie of the Rings. ||0 1 1
Altogether 15 people were rescued by police. 	The police rescued a lot of people. ||0 1 1
Some passengers were escorted off the ship in wheelchairs by crew wearing blue gloves. 	The passengers were escorting the passengers on a blue gloves with a wheelchair wearing the ship. ||0 1 1
The University of Milan was founded by Gian Antonio Maggi and Giulio Vivanti. 	Gian Antonio Maggi and Giulio Vivanti founded the University of Milan. ||1 1 1
Le Beau Serge was directed by Chabrol. 	Chabrol directed Le Beau Serge. ||1 1 1
He was sent by his company to Kazakhstan. 	His company sent him to Kazakhstan. ||1 1 1
The young girl was chased by the old man. 	The old man chased the old girl.  ||0 1 1
A young girl is chased by an old man. 	A young man is chased a young girl ||0 0 0
Tom was kidnapped by terrorists. 	The terrorists kidnapped Tom. ||1 1 1
I was abducted by aliens. 	The aliens were abducted me. ||1 0 0
The movie 'Speed' was directed by Jan De Bont. 	Speed directed the movie "Speed". ||0 1 1
The player was acclaimed by the fans. 	The fan was the player. ||0 1 0
A piano is being played by someone 	A person is playing a piano ||1 1 1
A flute is being played by a girl 	A girl is playing a flute ||1 1 1
Tom was abducted by aliens. 	The aliens was abducted Tom. ||1 0 0
Cisco was acquired by Infogear Technology Corp. 	Cisco acquired Infogear Technology Corp.  ||0 1 1
She was accepted by Harvard. 	Harvard accepted her. ||1 1 1
The college was founded by Mr Smith. 	Mr. Smith founded college. ||1 1 1
I was stung by a bee. 	The bee was stung by me. ||0 1 0
I got stung by this bee. 	The bee was stung by me. ||0 1 0
Tom was stung by a bee. 	Tom was stung by the bee. ||0 1 0
I got stung by a bee. 	The bee was stung by me. ||0 1 0
She was kissed by him. 	He kissed her. ||1 1 1
This novel was written by Emile Zola. 	Emile Zola wrote a novel. ||1 1 1
The telephone was invented by Bell in 1876. 	Bell invented the telephone in 1876. ||1 1 1
The Mona Lisa was painted by Leonardo da Vinci. 	Leonardo da Vinci painted Mona da Vinci. ||0 1 1
A hole is being burrowed by the badger 	The badger is burrowing a hole ||1 1 1
Some poems were also written by him. 	He wrote poems. ||1 1 1
The picture was painted by Picasso. 	Picasso painted this picture. ||1 1 1
That was written by Taro Akagawa. 	Taro Akagawa wrote it. ||1 1 1
This music was composed by Bach. 	Bach composed the music. ||1 1 1
The famous song "Ave Maria" was composed by Schubert. 	Schubert was composed a famous song. ||0 0 0
"The Persians" were written by Aeschylus. 	Aeschylus wrote "The Persians". ||1 1 1
The picture on the wall was painted by Picasso. 	Picasso painted a picture on the wall. ||1 1 1
"Consuming Kids" was written by Susan Linn. 	Susan Linn wrote the Consuming Kids. ||1 1 1
The poem was composed by an anonymous author. 	The anonymous author composed the poem. ||1 1 1
He was deserted by his friends. 	His friends deserted him. ||1 1 1
Tom was fingerprinted by the police. 	The police was fingerprinted by Tom. ||0 1 0
The room wasn't tidied by Rosa. 	The room didn't bother, Rosa. ||0 1 0
Tom folded the blankets.	The blanket was folding by Tom. ||1 0 0
The boy ate the apple.	The apple was eaten by the boy. ||1 1 1
The man ate the bread.	The bread was eaten by a man. ||1 1 1
The rabbit is eating the carrot.	Carrots are being eaten by a rabbit ||1 1 1
She smoked a cigarette.	She smoked by herself. ||0 1 0
She drank milk.	milk was drinking by her. ||1 0 0
Tom was eating a sandwich.	The sandwich was eaten by Tom. ||1 1 1
Tom sharpened the knife.	The knife was sharpened by Tom. ||1 1 1
Tom bit Mary.	Mary was bitten by Tom. ||1 1 1
He knocked at the door.	The door was knocked by him. ||1 0 1
The Japanese attacked Pearl Harbor on December 7, 1941.	Pearl was attacked by Japanese people on December 7, 1941. ||1 1 1
The dog is chewing a bone.	A bone is being chewing by a dog ||1 0 0
I pulled a triceps.	Then I was governed by me. ||0 1 0
The hunter shot a fox.	The fox shot by the hunter. ||1 0 0
The hunter shoots stags and hares.	The cherry hunter shot by the hare.  ||0 1 0
The workers are expanding the road.	The road is missing by the workers.  ||0 0 0
He sharpened the knives.	The knife was sharpened by him. ||1 1 1
The police officers have stopped me many times.	I've been stopped by a police officer. ||1 1 1
The spies poisoned the count.	The spy poisoned himself. ||0 1 0
A woman is slicing an eggplant	An eggplant is being sliced by a woman ||1 1 1
Tom unlocked the closet.	Tom unlocked by Tom. ||0 0 0
She shook my hand.	She shook my hand. ||1 1 0
Tom knocked on Mary's door.	Tom's door knocked on Mary's door. ||0 1 0
A crocodile has eaten Tom.	Tom ate by a crocodile. ||1 0 0
A crocodile ate a dog.	The dog ate by a crocodile. ||1 0 0
He was sharpening a knife.	The knife was sharpened by him. ||1 1 1
Tom shot Mary.	Mary shot by Tom. ||1 0 0
My father fixed a broken chair.	The broken chair was fixed by my father. ||1 1 1
Louis Riel assassinated Scott.	Scott Riel was assassinated by Louis Riel. ||0 1 1
My mother boiled ten eggs.	My mother was boiled by ten eggs. ||0 1 1
I eat a banana.	The banana are being eaten by me. ||1 1 1
The merchant bribed the politician.	The merchant bribe by politicians. ||1 0 0
The archer killed the deer.	The deer was killed by the killer. ||1 1 1
My dog bit Tom.	Tom was bitten by my dog. ||1 1 1
He shook his head.	He shook his head. ||1 1 0
A cat scratched me.	I was scratched by a cat. ||1 1 1
The cat scratched my hand.	My hand was scratched by the cat.||1 1 1
She stabbed him with a knife.	He stabbed himself with a knife. ||0 1 0
He ate the apple.	The apple was eating by him. ||1 0 0
She roasted the turkey.	Then the turkey was knitting by her. ||0 0 0
She chopped some onions.	An onion was chopped by her. ||1 1 1
He shot her.	She shot herself. ||0 1 0
A cow is eating hay	A hay is being eaten by a cow ||1 1 1
The dog sniffed the ground.	The ground was sniffing by the dog. ||1 0 0
In 1497, John Cabot explored Canada.	Canada was explored by John Cabot in 1497. ||1 1 1
The soldiers resisted the enemy attack.	The soldiers resisted the enemy attack. ||1 1 0
The old man captured a big fish.	The old fish was captured by a big man. ||0 1 1
Romania sent 730 troops in Iraq.	Romania sent 730 troops to Iraq. ||1 1 0
The president appointed a new manager.	The new manager was appointed by the president. ||1 1 1
Mrs. Jones teaches computer science.	Music is teaching by Mrs. Jones. ||0 0 0
My aunt inherited the huge estate.	The huge estate inherited my aunt.||0 1 0
The brave captain saved his ship.	His ship was saved by the brave captain. ||1 1 1
Tom accompanied Mary on the guitar.	Tom accompanied Mary on the guitar. ||1 1 0
The driver overtook the car.	The car was composed by the driver. ||0 1 0
Russia rejected both demands.	Russia rejected both demands. ||1 1 0
My friend invited me to dinner at the restaurant.	My friend invited me to dinner at the restaurant. ||1 1 0
Tom bought some croutons.	Has Tom bought some smoked? ||0 0 0
He bought a dozen eggs.	He bought a dozen eggs. ||1 1 0
BSN bought RJR Nabisco.	BSN was bought by RJR Nabisco. ||0 1 1
The tourists visit the museum.	The museum is being visited by a tourist. ||1 1 1
He visited Mauritania ten years ago.	Mauritania visited 10 years ago. ||0 1 0
She is visiting Paris.	Paris is visiting by her. ||1 0 0
Extremists kidnapped the president's wife.	The president was kidnapped by the president's wife. ||0 1 1
Looters stole ancient artifacts from the tomb.	The ancient "ancient" had stolen the tomb from the tomb. ||0 1 0
Someone stole my bag.	My bag was stolen by someone. ||1 1 1
Someone stole Tom's car.	Tom's car was stolen by someone. ||1 1 1
Tom stole three hundred dollars from Mary.	Tom stole 300 dollars from Mary. ||1 1 0
He acquired Russian quickly.	Russian acquired him quickly. ||0 1 0
Spartan Air Lines acquired United Airways.	The United Airways Lines was acquired by Spartan Air Lines. ||0 1 1
PM acquired three Russian factories.	PM acquired three Russian factories. ||1 1 0
She planted some pansies in the flower bed.	She was planted by a flower bed. ||0 1 1
They planted apple trees.	The apple tree was planted by someone. ||1 1 1
Tom planted three apple trees in his yard.	Tom was planted by three apple trees in his yard. ||0 1 1
The peasants were planting rice.	The rice was planted by the peasants. ||1 1 1
We discovered a secret passageway.	The secret passageway has been influenced by me. ||0 1 1
The tape recorder has recorded his voice.	His voice was recorded by the tape recorder. ||1 1 1
Tom rescued the cat from the flames.	The cat rescued Tom from flames. ||0 1 0
Tom and Mary rescued an orphaned kitten.	Tom and Mary were rescued by an orphaned kitten. ||0 1 1
Tom and Mary played ping pong.	Tom and Mary were playing ping pong. ||1 1 1
Tom beat Mary at checkers.	At checkers, Tom beat Mary. ||1 1 0
A child is playing harp.	A harp is being played by a child ||1 1 1
A dog chased a cat.	The cat was chased by the dog. ||1 1 1
Abrams chased Browne.	Abrams chased by Browne.  ||0 0 0
The policeman chased the burglar.	The policeman was chased by the burglar. ||1 1 1
Henry Ford founded the Ford Motor Company.	Henry Ford was founded by Henry Ford. ||0 1 1
Tom kissed Mary.	Mary kissed Tom. ||0 1 0
A lemur is licking a person's finger	A lemur is licking a person's finger  ||1 1 0
A dog is licking a baby	The baby is licking the dog  ||0 1 0
I promoted Tom.	Tom was promoted by I. ||1 0 1
The police accused him of murder.	He accused him of murder. ||0 1 1
I write poems.	This poem is writing by me. ||1 0 0
Lin Piao wrote the "Little Red Book".	The Little Red Book was written by Lin Piao. ||1 1 1
She wrote 5 novels in 5 years.	She wrote five novels for five years. ||1 1 0
Alfred Nobel invented dynamite in 1866.	In 1866, dynamite was invented by Alfred Nobel.||1 1 1
Thomas Edison invented the electric lightbulb.	The electric lightbulb was invented by Thomas Edison.||1 1 1
Picasso painted this picture in 1950.	This picture was painted by Picasso in 1950. ||1 1 1
He painted a dog.	The dog was painted by him.  ||1 1 1
He composed three poems in a month.	He was composed by three poems for a month. ||0 1 0
Tom composed a sonnet.	Tom was composed by Tom.||0 1 1
The badger is burrowing a hole	A hole is being sliced by a badger ||0 1 1
He dug a hole.	The hole dug by him. ||1 0 0
Tom dug a hole in the backyard.	Tom dug a hole in the backyard. ||1 1 0
The fairy changed the prince into a cat.	The prince changed the prince into the fairy. ||0 1 0
Tom wiped the table.	Tom wiped the table. ||1 1 0
She rinsed the dishes.	She rinsed the dishes from the dishes. ||0 1 0
He robbed an old lady. 	He robbed the old lady. ||1 1 0
